0 0 0 0 0 0 0 0 0 0 0 0
0 5 6 2 3 0 0 0 0 0 0 0
0 3 4 4 1 0 0 0 0 0 0 0
0 5 6 2 1 0 0 0 0 0 0 0
0 1 2 1 2 0 0 0 0 0 0 0
0 0 0 0 0 0 0 0 0 0 0 0
0 0 0 0 0 0 0 0 0 0 0 0
0 0 0 0 0 0 0 1 6 5 3 0
0 0 0 0 0 0 0 2 2 4 1 0
0 0 0 0 0 0 0 5 2 3 2 0
0 0 0 0 0 0 0 1 4 1 6 0
0 0 0 0 0 0 0 0 0 0 0 0
