0 0 0 0 0 0 0 0 0 0 0 0
0 1 2 1 3 0 0 0 0 0 0 0
0 4 5 2 6 0 0 0 0 0 0 0
0 4 5 3 6 0 0 0 0 0 0 0
0 1 2 3 1 0 0 0 0 0 0 0
0 0 0 0 0 0 0 0 0 0 0 0
0 0 0 0 0 0 0 0 0 0 0 0
0 0 0 0 0 0 0 1 4 2 5 0
0 0 0 0 0 0 0 1 4 2 5 0
0 0 0 0 0 0 0 3 6 3 6 0
0 0 0 0 0 0 0 2 1 5 4 0
0 0 0 0 0 0 0 0 0 0 0 0
