0 0 0 0 0 0 0 0 0 0 0 0
0 1 2 2 2 0 0 0 0 0 0 0
0 1 1 3 6 0 0 0 0 0 0 0
0 5 4 6 1 0 0 0 0 0 0 0
0 2 5 4 3 0 0 0 0 0 0 0
0 0 0 0 0 0 0 0 0 0 0 0
0 0 0 0 0 0 0 0 0 0 0 0
0 0 0 0 0 0 0 5 2 2 4 0
0 0 0 0 0 0 0 1 2 6 3 0
0 0 0 0 0 0 0 2 5 3 4 0
0 0 0 0 0 0 0 1 1 6 1 0
0 0 0 0 0 0 0 0 0 0 0 0
