0 0 0 0 0 0 0 0 0 0 0 0
0 2 5 3 6 0 0 0 0 0 0 0
0 1 6 4 2 0 0 0 0 0 0 0
0 4 5 1 1 0 0 0 0 0 0 0
0 2 3 1 2 0 0 0 0 0 0 0
0 0 0 0 0 0 0 0 0 0 0 0
0 0 0 0 0 0 0 0 0 0 0 0
0 0 0 0 0 0 0 2 1 3 1 0
0 0 0 0 0 0 0 4 5 6 2 0
0 0 0 0 0 0 0 3 2 4 6 0
0 0 0 0 0 0 0 1 5 1 2 0
0 0 0 0 0 0 0 0 0 0 0 0
