0 0 0 0 0 0 0 0 0 0 0 0
0 1 2 5 6 0 0 0 0 0 0 0
0 3 4 1 2 0 0 0 0 0 0 0
0 3 4 5 6 0 0 0 0 0 0 0
0 2 1 4 3 0 0 0 0 0 0 0
0 0 0 0 0 0 0 0 0 0 0 0
0 0 0 0 0 0 0 0 0 0 0 0
0 0 0 0 0 0 0 1 4 1 4 0
0 0 0 0 0 0 0 2 5 2 5 0
0 0 0 0 0 0 0 3 6 3 6 0
0 0 0 0 0 0 0 1 2 3 1 0
0 0 0 0 0 0 0 0 0 0 0 0
