0 0 0 0 0 0 0 0 0 0 0 0
0 5 4 2 2 0 0 0 0 0 0 0
0 2 1 1 3 0 0 0 0 0 0 0
0 5 2 1 4 0 0 0 0 0 0 0
0 6 3 1 6 0 0 0 0 0 0 0
0 0 0 0 0 0 0 0 0 0 0 0
0 0 0 0 0 0 0 0 0 0 0 0
0 0 0 0 0 0 0 3 3 2 1 0
0 0 0 0 0 0 0 1 1 5 6 0
0 0 0 0 0 0 0 4 6 1 2 0
0 0 0 0 0 0 0 4 2 2 5 0
0 0 0 0 0 0 0 0 0 0 0 0
