0 0 0 0 0 0 0 0 0 0 0 0
0 5 1 2 6 0 0 0 0 0 0 0
0 6 4 1 2 0 0 0 0 0 0 0
0 1 2 3 2 0 0 0 0 0 0 0
0 1 4 5 3 0 0 0 0 0 0 0
0 0 0 0 0 0 0 0 0 0 0 0
0 0 0 0 0 0 0 0 0 0 0 0
0 0 0 0 0 0 0 2 1 1 6 0
0 0 0 0 0 0 0 1 3 6 4 0
0 0 0 0 0 0 0 5 2 4 1 0
0 0 0 0 0 0 0 2 5 3 2 0
0 0 0 0 0 0 0 0 0 0 0 0
