0 0 0 0 0 0 0 0 0 0 0 0
0 3 2 1 1 0 0 0 0 0 0 0
0 3 2 4 5 0 0 0 0 0 0 0
0 1 2 1 6 0 0 0 0 0 0 0
0 2 6 4 5 0 0 0 0 0 0 0
0 0 0 0 0 0 0 0 0 0 0 0
0 0 0 0 0 0 0 0 0 0 0 0
0 0 0 0 0 0 0 2 3 3 1 0
0 0 0 0 0 0 0 1 6 2 2 0
0 0 0 0 0 0 0 5 2 4 1 0
0 0 0 0 0 0 0 1 4 6 5 0
0 0 0 0 0 0 0 0 0 0 0 0
