0 0 0 0 0 0 0 0 0 0 0 0
0 6 3 6 2 0 0 0 0 0 0 0
0 4 1 5 1 0 0 0 0 0 0 0
0 2 5 1 4 0 0 0 0 0 0 0
0 2 3 2 1 0 0 0 0 0 0 0
0 0 0 0 0 0 0 0 0 0 0 0
0 0 0 0 0 0 0 0 0 0 0 0
0 0 0 0 0 0 0 4 1 3 6 0
0 0 0 0 0 0 0 2 1 6 2 0
0 0 0 0 0 0 0 1 5 5 2 0
0 0 0 0 0 0 0 4 3 1 2 0
0 0 0 0 0 0 0 0 0 0 0 0
