0 0 0 0 0 0 0 0 0 0 0 0
0 1 1 2 2 0 0 0 0 0 0 0
0 3 3 4 4 0 0 0 0 0 0 0
0 5 5 6 6 0 0 0 0 0 0 0
0 2 4 1 3 0 0 0 0 0 0 0
0 0 0 0 0 0 0 0 0 0 0 0
0 0 0 0 0 0 0 0 0 0 0 0
0 0 0 0 0 0 0 1 3 2 4 0
0 0 0 0 0 0 0 1 3 2 4 0
0 0 0 0 0 0 0 5 6 5 6 0
0 0 0 0 0 0 0 2 1 4 3 0
0 0 0 0 0 0 0 0 0 0 0 0
