0 0 0 0 0 0 0 0 0 0 0 0
0 1 5 2 6 0 0 0 0 0 0 0
0 3 4 3 2 0 0 0 0 0 0 0
0 1 6 4 1 0 0 0 0 0 0 0
0 2 2 5 1 0 0 0 0 0 0 0
0 0 0 0 0 0 0 0 0 0 0 0
0 0 0 0 0 0 0 0 0 0 0 0
0 0 0 0 0 0 0 3 4 2 1 0
0 0 0 0 0 0 0 3 2 5 1 0
0 0 0 0 0 0 0 1 5 6 2 0
0 0 0 0 0 0 0 6 1 2 4 0
0 0 0 0 0 0 0 0 0 0 0 0
