0 0 0 0 0 0 0 0 0 0 0 0
0 6 2 1 3 0 0 0 0 0 0 0
0 3 4 1 2 0 0 0 0 0 0 0
0 4 5 1 1 0 0 0 0 0 0 0
0 5 2 6 2 0 0 0 0 0 0 0
0 0 0 0 0 0 0 0 0 0 0 0
0 0 0 0 0 0 0 0 0 0 0 0
0 0 0 0 0 0 0 4 3 3 2 0
0 0 0 0 0 0 0 4 5 1 1 0
0 0 0 0 0 0 0 5 2 1 2 0
0 0 0 0 0 0 0 1 6 6 2 0
0 0 0 0 0 0 0 0 0 0 0 0
