0 0 0 0 0 0 0 0 0 0 0 0
0 1 1 2 4 0 0 0 0 0 0 0
0 6 1 2 6 0 0 0 0 0 0 0
0 1 4 3 2 0 0 0 0 0 0 0
0 5 2 5 3 0 0 0 0 0 0 0
0 0 0 0 0 0 0 0 0 0 0 0
0 0 0 0 0 0 0 0 0 0 0 0
0 0 0 0 0 0 0 5 1 2 3 0
0 0 0 0 0 0 0 1 6 6 4 0
0 0 0 0 0 0 0 2 4 2 3 0
0 0 0 0 0 0 0 1 1 2 5 0
0 0 0 0 0 0 0 0 0 0 0 0
