0 0 0 0 0 0 0 0 0 0 0 0
0 2 5 1 2 0 0 0 0 0 0 0
0 1 6 3 5 0 0 0 0 0 0 0
0 1 4 4 3 0 0 0 0 0 0 0
0 2 1 2 6 0 0 0 0 0 0 0
0 0 0 0 0 0 0 0 0 0 0 0
0 0 0 0 0 0 0 0 0 0 0 0
0 0 0 0 0 0 0 6 1 2 3 0
0 0 0 0 0 0 0 5 4 4 5 0
0 0 0 0 0 0 0 2 1 2 3 0
0 0 0 0 0 0 0 6 1 2 1 0
0 0 0 0 0 0 0 0 0 0 0 0
