0 0 0 0 0 0 0 0 0 0 0 0
0 6 5 2 4 0 0 0 0 0 0 0
0 2 1 1 3 0 0 0 0 0 0 0
0 1 2 4 2 0 0 0 0 0 0 0
0 1 6 3 5 0 0 0 0 0 0 0
0 0 0 0 0 0 0 0 0 0 0 0
0 0 0 0 0 0 0 0 0 0 0 0
0 0 0 0 0 0 0 6 6 5 2 0
0 0 0 0 0 0 0 3 4 1 2 0
0 0 0 0 0 0 0 3 2 1 5 0
0 0 0 0 0 0 0 2 1 4 1 0
0 0 0 0 0 0 0 0 0 0 0 0
