0 0 0 0 0 0 0 0 0 0 0 0
0 1 3 1 3 0 0 0 0 0 0 0
0 2 4 2 4 0 0 0 0 0 0 0
0 5 6 5 6 0 0 0 0 0 0 0
0 1 2 3 4 0 0 0 0 0 0 0
0 0 0 0 0 0 0 0 0 0 0 0
0 0 0 0 0 0 0 0 0 0 0 0
0 0 0 0 0 0 0 1 2 4 5 0
0 0 0 0 0 0 0 3 1 6 2 0
0 0 0 0 0 0 0 3 4 6 5 0
0 0 0 0 0 0 0 2 3 1 4 0
0 0 0 0 0 0 0 0 0 0 0 0
