0 0 0 0 0 0 0 0 0 0 0 0
0 3 3 1 6 0 0 0 0 0 0 0
0 1 1 2 1 0 0 0 0 0 0 0
0 5 4 5 2 0 0 0 0 0 0 0
0 4 2 2 6 0 0 0 0 0 0 0
0 0 0 0 0 0 0 0 0 0 0 0
0 0 0 0 0 0 0 0 0 0 0 0
0 0 0 0 0 0 0 1 3 1 1 0
0 0 0 0 0 0 0 2 4 4 5 0
0 0 0 0 0 0 0 2 6 3 5 0
0 0 0 0 0 0 0 2 6 2 1 0
0 0 0 0 0 0 0 0 0 0 0 0
