0 0 0 0 0 0 0 0 0 0 0 0
0 5 1 1 1 0 0 0 0 0 0 0
0 5 1 4 6 0 0 0 0 0 0 0
0 2 2 6 2 0 0 0 0 0 0 0
0 3 3 4 2 0 0 0 0 0 0 0
0 0 0 0 0 0 0 0 0 0 0 0
0 0 0 0 0 0 0 0 0 0 0 0
0 0 0 0 0 0 0 2 2 1 1 0
0 0 0 0 0 0 0 4 2 6 2 0
0 0 0 0 0 0 0 3 4 1 6 0
0 0 0 0 0 0 0 5 5 1 3 0
0 0 0 0 0 0 0 0 0 0 0 0
