0 0 0 0 0 0 0 0 0 0 0 0
0 1 2 6 2 0 0 0 0 0 0 0
0 1 3 1 3 0 0 0 0 0 0 0
0 5 2 4 5 0 0 0 0 0 0 0
0 2 4 6 1 0 0 0 0 0 0 0
0 0 0 0 0 0 0 0 0 0 0 0
0 0 0 0 0 0 0 0 0 0 0 0
0 0 0 0 0 0 0 3 3 2 4 0
0 0 0 0 0 0 0 6 1 1 6 0
0 0 0 0 0 0 0 5 4 5 2 0
0 0 0 0 0 0 0 1 1 2 2 0
0 0 0 0 0 0 0 0 0 0 0 0
