0 0 0 0 0 0 0 0 0 0 0 0
0 1 2 4 1 0 0 0 0 0 0 0
0 6 2 2 6 0 0 0 0 0 0 0
0 1 1 3 4 0 0 0 0 0 0 0
0 5 3 5 2 0 0 0 0 0 0 0
0 0 0 0 0 0 0 0 0 0 0 0
0 0 0 0 0 0 0 0 0 0 0 0
0 0 0 0 0 0 0 6 5 2 3 0
0 0 0 0 0 0 0 2 1 5 4 0
0 0 0 0 0 0 0 4 2 1 2 0
0 0 0 0 0 0 0 6 1 3 1 0
0 0 0 0 0 0 0 0 0 0 0 0
