0 0 0 0 0 0 0 0 0 0 0 0
0 3 5 4 2 0 0 0 0 0 0 0
0 1 2 5 1 0 0 0 0 0 0 0
0 2 1 6 6 0 0 0 0 0 0 0
0 2 4 3 1 0 0 0 0 0 0 0
0 0 0 0 0 0 0 0 0 0 0 0
0 0 0 0 0 0 0 0 0 0 0 0
0 0 0 0 0 0 0 5 3 2 1 0
0 0 0 0 0 0 0 6 6 1 2 0
0 0 0 0 0 0 0 1 2 3 1 0
0 0 0 0 0 0 0 4 2 5 4 0
0 0 0 0 0 0 0 0 0 0 0 0
