0 0 0 0 0 0 0 0 0 0 0 0
0 1 2 5 6 0 0 0 0 0 0 0
0 4 2 5 3 0 0 0 0 0 0 0
0 3 2 1 4 0 0 0 0 0 0 0
0 1 1 2 6 0 0 0 0 0 0 0
0 0 0 0 0 0 0 0 0 0 0 0
0 0 0 0 0 0 0 0 0 0 0 0
0 0 0 0 0 0 0 6 3 2 2 0
0 0 0 0 0 0 0 1 6 4 1 0
0 0 0 0 0 0 0 1 2 3 5 0
0 0 0 0 0 0 0 4 2 5 1 0
0 0 0 0 0 0 0 0 0 0 0 0
