0 0 0 0 0 0 0 0 0 0 0 0
0 5 1 3 4 0 0 0 0 0 0 0
0 2 3 2 2 0 0 0 0 0 0 0
0 2 1 4 6 0 0 0 0 0 0 0
0 1 6 1 5 0 0 0 0 0 0 0
0 0 0 0 0 0 0 0 0 0 0 0
0 0 0 0 0 0 0 0 0 0 0 0
0 0 0 0 0 0 0 4 1 3 4 0
0 0 0 0 0 0 0 1 2 1 5 0
0 0 0 0 0 0 0 6 5 1 2 0
0 0 0 0 0 0 0 6 2 2 3 0
0 0 0 0 0 0 0 0 0 0 0 0
