0 0 0 0 0 0 0 0 0 0 0 0
0 1 6 4 3 0 0 0 0 0 0 0
0 2 6 2 2 0 0 0 0 0 0 0
0 4 5 1 3 0 0 0 0 0 0 0
0 1 2 5 1 0 0 0 0 0 0 0
0 0 0 0 0 0 0 0 0 0 0 0
0 0 0 0 0 0 0 0 0 0 0 0
0 0 0 0 0 0 0 5 2 2 2 0
0 0 0 0 0 0 0 1 3 6 3 0
0 0 0 0 0 0 0 5 4 1 4 0
0 0 0 0 0 0 0 1 6 1 2 0
0 0 0 0 0 0 0 0 0 0 0 0
