0 0 0 0 0 0 0 0 0 0 0 0
0 5 2 3 4 0 0 0 0 0 0 0
0 1 6 2 4 0 0 0 0 0 0 0
0 1 3 2 5 0 0 0 0 0 0 0
0 6 2 1 1 0 0 0 0 0 0 0
0 0 0 0 0 0 0 0 0 0 0 0
0 0 0 0 0 0 0 0 0 0 0 0
0 0 0 0 0 0 0 6 2 5 3 0
0 0 0 0 0 0 0 4 6 4 1 0
0 0 0 0 0 0 0 1 1 1 5 0
0 0 0 0 0 0 0 2 2 2 3 0
0 0 0 0 0 0 0 0 0 0 0 0
