0 0 0 0 0 0 0 0 0 0 0 0
0 3 2 1 1 0 0 0 0 0 0 0
0 4 2 5 6 0 0 0 0 0 0 0
0 4 3 1 2 0 0 0 0 0 0 0
0 2 5 1 6 0 0 0 0 0 0 0
0 0 0 0 0 0 0 0 0 0 0 0
0 0 0 0 0 0 0 0 0 0 0 0
0 0 0 0 0 0 0 6 4 2 1 0
0 0 0 0 0 0 0 3 1 5 2 0
0 0 0 0 0 0 0 2 6 5 4 0
0 0 0 0 0 0 0 1 3 2 1 0
0 0 0 0 0 0 0 0 0 0 0 0
