0 0 0 0 0 0 0 0 0 0 0 0
0 4 6 6 1 0 0 0 0 0 0 0
0 2 2 3 2 0 0 0 0 0 0 0
0 2 3 1 1 0 0 0 0 0 0 0
0 1 5 4 5 0 0 0 0 0 0 0
0 0 0 0 0 0 0 0 0 0 0 0
0 0 0 0 0 0 0 0 0 0 0 0
0 0 0 0 0 0 0 1 2 6 1 0
0 0 0 0 0 0 0 2 5 1 5 0
0 0 0 0 0 0 0 4 2 1 2 0
0 0 0 0 0 0 0 3 3 6 4 0
0 0 0 0 0 0 0 0 0 0 0 0
