0 0 0 0 0 0 0 0 0 0 0 0
0 4 1 1 4 0 0 0 0 0 0 0
0 5 2 3 2 0 0 0 0 0 0 0
0 1 5 2 6 0 0 0 0 0 0 0
0 6 2 1 3 0 0 0 0 0 0 0
0 0 0 0 0 0 0 0 0 0 0 0
0 0 0 0 0 0 0 0 0 0 0 0
0 0 0 0 0 0 0 2 2 5 3 0
0 0 0 0 0 0 0 4 6 1 3 0
0 0 0 0 0 0 0 6 1 5 1 0
0 0 0 0 0 0 0 1 2 4 2 0
0 0 0 0 0 0 0 0 0 0 0 0
