0 0 0 0 0 0 0 0 0 0 0 0
0 1 3 2 4 0 0 0 0 0 0 0
0 1 3 2 4 0 0 0 0 0 0 0
0 5 6 1 2 0 0 0 0 0 0 0
0 5 6 3 4 0 0 0 0 0 0 0
0 0 0 0 0 0 0 0 0 0 0 0
0 0 0 0 0 0 0 0 0 0 0 0
0 0 0 0 0 0 0 1 2 5 6 0
0 0 0 0 0 0 0 3 4 1 2 0
0 0 0 0 0 0 0 3 4 5 6 0
0 0 0 0 0 0 0 2 1 4 3 0
0 0 0 0 0 0 0 0 0 0 0 0
