0 0 0 0 0 0 0 0 0 0 0 0
0 1 4 2 5 0 0 0 0 0 0 0
0 1 4 2 5 0 0 0 0 0 0 0
0 3 6 3 6 0 0 0 0 0 0 0
0 2 1 5 4 0 0 0 0 0 0 0
0 0 0 0 0 0 0 0 0 0 0 0
0 0 0 0 0 0 0 0 0 0 0 0
0 0 0 0 0 0 0 1 2 3 4 0
0 0 0 0 0 0 0 5 1 6 2 0
0 0 0 0 0 0 0 3 4 5 6 0
0 0 0 0 0 0 0 1 3 2 4 0
0 0 0 0 0 0 0 0 0 0 0 0
