0 0 0 0 0 0 0 0 0 0 0 0
0 1 1 6 4 0 0 0 0 0 0 0
0 5 2 1 2 0 0 0 0 0 0 0
0 4 2 1 3 0 0 0 0 0 0 0
0 6 5 2 3 0 0 0 0 0 0 0
0 0 0 0 0 0 0 0 0 0 0 0
0 0 0 0 0 0 0 0 0 0 0 0
0 0 0 0 0 0 0 2 1 1 5 0
0 0 0 0 0 0 0 6 4 1 5 0
0 0 0 0 0 0 0 3 3 2 1 0
0 0 0 0 0 0 0 4 2 2 6 0
0 0 0 0 0 0 0 0 0 0 0 0
