0 0 0 0 0 0 0 0 0 0 0 0
0 4 2 5 1 0 0 0 0 0 0 0
0 5 1 2 6 0 0 0 0 0 0 0
0 4 2 3 6 0 0 0 0 0 0 0
0 3 2 1 1 0 0 0 0 0 0 0
0 0 0 0 0 0 0 0 0 0 0 0
0 0 0 0 0 0 0 0 0 0 0 0
0 0 0 0 0 0 0 6 4 2 1 0
0 0 0 0 0 0 0 5 2 1 1 0
0 0 0 0 0 0 0 5 3 2 4 0
0 0 0 0 0 0 0 1 2 3 6 0
0 0 0 0 0 0 0 0 0 0 0 0
