0 0 0 0 0 0 0 0 0 0 0 0
0 6 3 2 4 0 0 0 0 0 0 0
0 2 1 3 1 0 0 0 0 0 0 0
0 5 1 4 2 0 0 0 0 0 0 0
0 6 5 1 2 0 0 0 0 0 0 0
0 0 0 0 0 0 0 0 0 0 0 0
0 0 0 0 0 0 0 0 0 0 0 0
0 0 0 0 0 0 0 1 6 3 2 0
0 0 0 0 0 0 0 3 4 4 5 0
0 0 0 0 0 0 0 6 1 2 1 0
0 0 0 0 0 0 0 5 2 1 2 0
0 0 0 0 0 0 0 0 0 0 0 0
