0 0 0 0 0 0 0 0 0 0 0 0
0 2 6 6 4 0 0 0 0 0 0 0
0 1 5 2 3 0 0 0 0 0 0 0
0 2 2 5 1 0 0 0 0 0 0 0
0 1 1 3 4 0 0 0 0 0 0 0
0 0 0 0 0 0 0 0 0 0 0 0
0 0 0 0 0 0 0 0 0 0 0 0
0 0 0 0 0 0 0 3 1 1 1 0
0 0 0 0 0 0 0 4 2 6 2 0
0 0 0 0 0 0 0 6 3 4 2 0
0 0 0 0 0 0 0 5 5 2 1 0
0 0 0 0 0 0 0 0 0 0 0 0
