0 0 0 0 0 0 0 0 0 0 0 0
0 1 2 4 2 0 0 0 0 0 0 0
0 1 1 5 3 0 0 0 0 0 0 0
0 6 1 4 2 0 0 0 0 0 0 0
0 2 6 3 5 0 0 0 0 0 0 0
0 0 0 0 0 0 0 0 0 0 0 0
0 0 0 0 0 0 0 0 0 0 0 0
0 0 0 0 0 0 0 4 5 4 2 0
0 0 0 0 0 0 0 1 6 3 1 0
0 0 0 0 0 0 0 2 2 6 1 0
0 0 0 0 0 0 0 2 3 1 5 0
0 0 0 0 0 0 0 0 0 0 0 0
