0 0 0 0 0 0 0 0 0 0 0 0
0 1 3 4 6 0 0 0 0 0 0 0
0 1 5 1 1 0 0 0 0 0 0 0
0 3 2 2 2 0 0 0 0 0 0 0
0 2 6 5 4 0 0 0 0 0 0 0
0 0 0 0 0 0 0 0 0 0 0 0
0 0 0 0 0 0 0 0 0 0 0 0
0 0 0 0 0 0 0 2 2 6 1 0
0 0 0 0 0 0 0 2 4 4 2 0
0 0 0 0 0 0 0 1 3 1 5 0
0 0 0 0 0 0 0 1 6 3 5 0
0 0 0 0 0 0 0 0 0 0 0 0
