0 1 6 2 4 0 0 0 0 0 0 0
0 3 3 1 1 0 0 0 0 0 0 0
0 1 5 2 6 0 0 0 0 0 0 0
0 2 2 5 4 0 0 0 0 0 0 0
0 0 0 0 0 0 0 0 0 0 0 0
0 0 0 0 0 0 0 0 0 0 0 0
0 0 0 0 0 0 0 3 1 2 1 0
0 0 0 0 0 0 0 4 6 6 5 0
0 0 0 0 0 0 0 4 2 1 2 0
0 0 0 0 0 0 0 5 3 2 1 0
0 0 0 0 0 0 0 0 0 0 0 0
