0 0 0 0 0 0 0 0 0 0 0 0
0 1 2 1 3 0 0 0 0 0 0 0
0 2 4 6 5 0 0 0 0 0 0 0
0 2 6 1 3 0 0 0 0 0 0 0
0 4 1 2 5 0 0 0 0 0 0 0
0 0 0 0 0 0 0 0 0 0 0 0
0 0 0 0 0 0 0 0 0 0 0 0
0 0 0 0 0 0 0 1 1 4 1 0
0 0 0 0 0 0 0 6 5 3 2 0
0 0 0 0 0 0 0 6 2 4 2 0
0 0 0 0 0 0 0 3 5 2 1 0
0 0 0 0 0 0 0 0 0 0 0 0
