0 0 0 0 0 0 0 0 0 0 0 0
0 4 1 2 5 0 0 0 0 0 0 0
0 3 3 1 6 0 0 0 0 0 0 0
0 2 6 2 2 0 0 0 0 0 0 0
0 5 4 1 1 0 0 0 0 0 0 0
0 0 0 0 0 0 0 0 0 0 0 0
0 0 0 0 0 0 0 0 0 0 0 0
0 0 0 0 0 0 0 1 2 2 1 0
0 0 0 0 0 0 0 5 6 2 2 0
0 0 0 0 0 0 0 6 1 3 5 0
0 0 0 0 0 0 0 4 1 4 3 0
0 0 0 0 0 0 0 0 0 0 0 0
