0 0 0 0 0 0 0 0 0 0 0 0
0 1 6 1 1 0 0 0 0 0 0 0
0 4 6 1 5 0 0 0 0 0 0 0
0 2 2 3 3 0 0 0 0 0 0 0
0 2 2 5 4 0 0 0 0 0 0 0
0 0 0 0 0 0 0 0 0 0 0 0
0 0 0 0 0 0 0 0 0 0 0 0
0 0 0 0 0 0 0 2 2 4 2 0
0 0 0 0 0 0 0 1 5 1 3 0
0 0 0 0 0 0 0 2 1 6 3 0
0 0 0 0 0 0 0 5 6 1 4 0
0 0 0 0 0 0 0 0 0 0 0 0
