0 0 0 0 0 0 0 0 0 0 0 0
0 1 5 1 3 0 0 0 0 0 0 0
0 2 1 2 6 0 0 0 0 0 0 0
0 2 4 6 4 0 0 0 0 0 0 0
0 5 1 3 2 0 0 0 0 0 0 0
0 0 0 0 0 0 0 0 0 0 0 0
0 0 0 0 0 0 0 0 0 0 0 0
0 0 0 0 0 0 0 4 6 2 5 0
0 0 0 0 0 0 0 2 5 1 4 0
0 0 0 0 0 0 0 1 2 1 1 0
0 0 0 0 0 0 0 3 3 6 2 0
0 0 0 0 0 0 0 0 0 0 0 0
