0 0 0 0 0 0 0 0 0 0 0 0
0 1 2 1 6 0 0 0 0 0 0 0
0 4 2 2 4 0 0 0 0 0 0 0
0 3 1 3 5 0 0 0 0 0 0 0
0 6 2 1 5 0 0 0 0 0 0 0
0 0 0 0 0 0 0 0 0 0 0 0
0 0 0 0 0 0 0 0 0 0 0 0
0 0 0 0 0 0 0 6 2 1 5 0
0 0 0 0 0 0 0 1 2 1 2 0
0 0 0 0 0 0 0 4 3 6 2 0
0 0 0 0 0 0 0 3 4 5 1 0
0 0 0 0 0 0 0 0 0 0 0 0
