0 0 0 0 0 0 0 0 0 0 0 0
0 5 1 2 4 0 0 0 0 0 0 0
0 2 3 3 1 0 0 0 0 0 0 0
0 1 1 6 5 0 0 0 0 0 0 0
0 2 6 2 4 0 0 0 0 0 0 0
0 0 0 0 0 0 0 0 0 0 0 0
0 0 0 0 0 0 0 0 0 0 0 0
0 0 0 0 0 0 0 4 3 6 2 0
0 0 0 0 0 0 0 2 1 5 2 0
0 0 0 0 0 0 0 1 1 6 5 0
0 0 0 0 0 0 0 4 1 3 2 0
0 0 0 0 0 0 0 0 0 0 0 0
