0 0 0 0 0 0 0 0 0 0 0 0
0 3 1 4 2 0 0 0 0 0 0 0
0 1 6 1 5 0 0 0 0 0 0 0
0 5 2 3 1 0 0 0 0 0 0 0
0 4 2 2 6 0 0 0 0 0 0 0
0 0 0 0 0 0 0 0 0 0 0 0
0 0 0 0 0 0 0 0 0 0 0 0
0 0 0 0 0 0 0 2 1 5 3 0
0 0 0 0 0 0 0 6 1 4 5 0
0 0 0 0 0 0 0 1 2 3 1 0
0 0 0 0 0 0 0 4 2 2 6 0
0 0 0 0 0 0 0 0 0 0 0 0
