0 0 0 0 0 0 0 0 0 0 0 0
0 4 2 3 5 0 0 0 0 0 0 0
0 2 1 2 1 0 0 0 0 0 0 0
0 1 2 4 6 0 0 0 0 0 0 0
0 5 1 3 6 0 0 0 0 0 0 0
0 0 0 0 0 0 0 0 0 0 0 0
0 0 0 0 0 0 0 0 0 0 0 0
0 0 0 0 0 0 0 1 2 2 1 0
0 0 0 0 0 0 0 3 4 6 5 0
0 0 0 0 0 0 0 1 6 4 2 0
0 0 0 0 0 0 0 3 1 5 2 0
0 0 0 0 0 0 0 0 0 0 0 0
