0 0 0 0 0 0 0 0 0 0 0 0
0 6 1 3 2 0 0 0 0 0 0 0
0 2 4 1 1 0 0 0 0 0 0 0
0 1 2 5 4 0 0 0 0 0 0 0
0 2 3 5 6 0 0 0 0 0 0 0
0 0 0 0 0 0 0 0 0 0 0 0
0 0 0 0 0 0 0 0 0 0 0 0
0 0 0 0 0 0 0 1 5 1 1 0
0 0 0 0 0 0 0 2 6 2 3 0
0 0 0 0 0 0 0 4 4 5 2 0
0 0 0 0 0 0 0 6 1 3 2 0
0 0 0 0 0 0 0 0 0 0 0 0
