0 0 0 0 0 0 0 0 0 0 0 0
0 1 4 4 5 0 0 0 0 0 0 0
0 2 6 1 2 0 0 0 0 0 0 0
0 3 3 1 2 0 0 0 0 0 0 0
0 6 1 5 2 0 0 0 0 0 0 0
0 0 0 0 0 0 0 0 0 0 0 0
0 0 0 0 0 0 0 0 0 0 0 0
0 0 0 0 0 0 0 4 3 5 2 0
0 0 0 0 0 0 0 4 2 1 6 0
0 0 0 0 0 0 0 1 2 1 2 0
0 0 0 0 0 0 0 3 5 6 1 0
0 0 0 0 0 0 0 0 0 0 0 0
