0 0 0 0 0 0 0 0 0 0 0 0
0 4 1 3 4 0 0 0 0 0 0 0
0 3 2 1 1 0 0 0 0 0 0 0
0 6 2 2 2 0 0 0 0 0 0 0
0 6 1 5 5 0 0 0 0 0 0 0
0 0 0 0 0 0 0 0 0 0 0 0
0 0 0 0 0 0 0 0 0 0 0 0
0 0 0 0 0 0 0 4 1 1 1 0
0 0 0 0 0 0 0 6 2 5 5 0
0 0 0 0 0 0 0 6 2 3 4 0
0 0 0 0 0 0 0 2 3 1 2 0
0 0 0 0 0 0 0 0 0 0 0 0
