0 0 0 0 0 0 0 0 0 0 0 0
0 4 1 5 1 0 0 0 0 0 0 0
0 2 4 2 1 0 0 0 0 0 0 0
0 2 3 1 5 0 0 0 0 0 0 0
0 6 3 2 6 0 0 0 0 0 0 0
0 0 0 0 0 0 0 0 0 0 0 0
0 0 0 0 0 0 0 0 0 0 0 0
0 0 0 0 0 0 0 6 2 5 2 0
0 0 0 0 0 0 0 5 4 1 2 0
0 0 0 0 0 0 0 3 3 1 4 0
0 0 0 0 0 0 0 1 1 6 2 0
0 0 0 0 0 0 0 0 0 0 0 0
