0 0 0 0 0 0 0 0 0 0 0 0
0 4 2 3 6 0 0 0 0 0 0 0
0 3 1 1 2 0 0 0 0 0 0 0
0 6 5 1 1 0 0 0 0 0 0 0
0 2 4 2 5 0 0 0 0 0 0 0
0 0 0 0 0 0 0 0 0 0 0 0
0 0 0 0 0 0 0 0 0 0 0 0
0 0 0 0 0 0 0 6 5 1 2 0
0 0 0 0 0 0 0 2 4 3 3 0
0 0 0 0 0 0 0 6 1 1 2 0
0 0 0 0 0 0 0 1 5 4 2 0
0 0 0 0 0 0 0 0 0 0 0 0
