0 0 0 0 0 0 0 0 0 0 0 0
0 2 3 1 4 0 0 0 0 0 0 0
0 4 5 1 1 0 0 0 0 0 0 0
0 2 6 2 3 0 0 0 0 0 0 0
0 6 1 5 2 0 0 0 0 0 0 0
0 0 0 0 0 0 0 0 0 0 0 0
0 0 0 0 0 0 0 0 0 0 0 0
0 0 0 0 0 0 0 4 1 1 5 0
0 0 0 0 0 0 0 3 6 4 6 0
0 0 0 0 0 0 0 2 3 5 2 0
0 0 0 0 0 0 0 1 1 2 2 0
0 0 0 0 0 0 0 0 0 0 0 0
