0 0 0 0 0 0 0 0 0 0 0 0
0 6 5 1 2 0 0 0 0 0 0 0
0 3 2 5 2 0 0 0 0 0 0 0
0 1 1 4 6 0 0 0 0 0 0 0
0 4 3 2 1 0 0 0 0 0 0 0
0 0 0 0 0 0 0 0 0 0 0 0
0 0 0 0 0 0 0 0 0 0 0 0
0 0 0 0 0 0 0 4 1 2 5 0
0 0 0 0 0 0 0 2 4 1 1 0
0 0 0 0 0 0 0 2 3 1 6 0
0 0 0 0 0 0 0 6 5 3 2 0
0 0 0 0 0 0 0 0 0 0 0 0
