0 0 0 0 0 0 0 0 0 0 0 0
0 1 1 3 3 0 0 0 0 0 0 0
0 2 2 4 4 0 0 0 0 0 0 0
0 5 5 6 6 0 0 0 0 0 0 0
0 3 1 4 2 0 0 0 0 0 0 0
0 0 0 0 0 0 0 0 0 0 0 0
0 0 0 0 0 0 0 0 0 0 0 0
0 0 0 0 0 0 0 1 2 3 1 0
0 0 0 0 0 0 0 2 4 5 3 0
0 0 0 0 0 0 0 6 1 2 6 0
0 0 0 0 0 0 0 4 5 3 4 0
0 0 0 0 0 0 0 0 0 0 0 0
