0 0 0 0 0 0 0 0 0 0 0 0
0 2 6 5 6 0 0 0 0 0 0 0
0 1 2 4 2 0 0 0 0 0 0 0
0 1 3 4 1 0 0 0 0 0 0 0
0 1 3 2 5 0 0 0 0 0 0 0
0 0 0 0 0 0 0 0 0 0 0 0
0 0 0 0 0 0 0 0 0 0 0 0
0 0 0 0 0 0 0 4 1 5 1 0
0 0 0 0 0 0 0 2 4 3 2 0
0 0 0 0 0 0 0 2 1 3 6 0
0 0 0 0 0 0 0 2 6 1 5 0
0 0 0 0 0 0 0 0 0 0 0 0
