0 0 0 0 0 0 0 0 0 0 0 0
0 1 2 3 2 0 0 0 0 0 0 0
0 1 4 1 6 0 0 0 0 0 0 0
0 5 4 1 2 0 0 0 0 0 0 0
0 3 5 2 6 0 0 0 0 0 0 0
0 0 0 0 0 0 0 0 0 0 0 0
0 0 0 0 0 0 0 0 0 0 0 0
0 0 0 0 0 0 0 3 6 4 3 0
0 0 0 0 0 0 0 4 6 5 2 0
0 0 0 0 0 0 0 2 1 2 1 0
0 0 0 0 0 0 0 1 1 5 2 0
0 0 0 0 0 0 0 0 0 0 0 0
