0 0 0 0 0 0 0 0 0 0 0 0
0 3 1 4 2 0 0 0 0 0 0 0
0 2 1 1 1 0 0 0 0 0 0 0
0 6 5 6 4 0 0 0 0 0 0 0
0 2 3 5 2 0 0 0 0 0 0 0
0 0 0 0 0 0 0 0 0 0 0 0
0 0 0 0 0 0 0 0 0 0 0 0
0 0 0 0 0 0 0 6 3 3 2 0
0 0 0 0 0 0 0 5 4 5 1 0
0 0 0 0 0 0 0 1 2 1 1 0
0 0 0 0 0 0 0 4 2 6 2 0
0 0 0 0 0 0 0 0 0 0 0 0
