0 0 0 0 0 0 0 0 0 0 0 0
0 1 10 2 9 3 8 4 7 5 6 0
0 1 10 2 9 3 8 4 7 5 6 0
0 11 14 12 13 1 10 2 9 3 8 0
0 11 14 12 13 1 10 2 9 3 8 0
0 4 7 5 6 11 14 12 13 1 10 0
0 4 7 5 6 11 14 12 13 1 10 0
0 2 9 3 8 4 7 5 6 11 14 0
0 2 9 3 8 4 7 5 6 11 14 0
0 12 13 1 10 2 9 3 8 4 7 0
0 12 13 1 10 2 9 3 8 4 7 0
0 0 0 0 0 0 0 0 0 0 0 0
