0 0 0 0 0 0 0 0 0 0 0 0
0 1 2 4 7 11 1 2 4 7 11 0
0 3 5 8 12 13 3 5 8 12 13 0
0 6 9 10 14 1 6 9 10 14 1 0
0 2 4 7 11 3 2 4 7 11 3 0
0 5 8 12 13 6 5 8 12 13 6 0
0 9 10 14 1 2 9 10 14 1 2 0
0 4 7 11 3 5 4 7 11 3 5 0
0 8 12 13 6 9 8 12 13 6 9 0
0 10 14 1 2 4 10 14 1 2 4 0
0 7 11 3 5 8 7 11 3 5 8 0
0 0 0 0 0 0 0 0 0 0 0 0
