0 0 0 0 0 0 0 0 0 0 0 0
0 6 2 4 14 11 2 12 3 12 3 0
0 14 13 14 4 6 5 13 4 9 11 0
0 5 3 2 10 9 3 14 11 7 13 0
0 5 10 9 12 12 1 12 1 4 2 0
0 8 1 7 13 9 7 11 13 2 12 0
0 7 6 3 11 10 4 11 9 2 1 0
0 7 1 8 1 1 14 10 10 6 8 0
0 12 8 1 2 14 7 4 8 8 10 0
0 5 5 10 6 13 8 6 5 3 9 0
0 11 13 3 4 8 9 14 5 6 7 0
0 0 0 0 0 0 0 0 0 0 0 0
