0 0 0 0 0 0 0 0 0 0 0 0
0 1 3 6 8 11 13 2 4 5 7 0
0 9 12 14 1 3 6 8 11 13 2 0
0 4 5 7 9 12 14 1 3 6 8 0
0 11 13 2 4 5 7 9 12 14 1 0
0 3 6 8 11 13 2 4 5 7 9 0
0 12 14 1 3 6 8 11 13 2 4 0
0 5 7 9 12 14 1 3 6 8 11 0
0 13 2 4 5 7 9 12 14 1 3 0
0 6 8 11 13 2 4 5 7 9 12 0
0 14 1 3 6 8 11 13 2 4 5 0
0 0 0 0 0 0 0 0 0 0 0 0
