0 0 0 0 0 0 0 0 0 0 0 0
0 1 2 3 4 5 1 2 3 4 5 0
0 6 7 8 9 10 6 7 8 9 10 0
0 11 12 13 14 1 11 12 13 14 1 0
0 2 3 4 5 6 2 3 4 5 6 0
0 7 8 9 10 11 7 8 9 10 11 0
0 12 13 14 1 2 12 13 14 1 2 0
0 3 4 5 6 7 3 4 5 6 7 0
0 8 9 10 11 12 8 9 10 11 12 0
0 13 14 1 2 3 13 14 1 2 3 0
0 4 5 6 7 8 4 5 6 7 8 0
0 0 0 0 0 0 0 0 0 0 0 0
