0 0 0 0 0 0 0 0 0 0 0 0
0 2 5 8 11 2 5 8 11 1 4 0
0 9 13 13 9 1 4 10 12 10 12 0
0 3 6 7 14 3 6 7 14 2 5 0
0 8 11 1 4 8 11 1 4 9 13 0
0 10 12 3 6 10 12 3 6 7 14 0
0 2 5 7 14 2 5 7 14 8 11 0
0 1 4 9 13 1 4 9 13 10 12 0
0 3 6 2 5 3 6 2 5 1 4 0
0 8 11 10 12 8 11 10 12 3 6 0
0 7 14 1 4 7 14 1 4 2 5 0
0 0 0 0 0 0 0 0 0 0 0 0
