0 0 0 0 0 0 0 0 0 0 0 0
0 3 9 14 4 9 7 3 2 13 1 0
0 4 12 10 2 3 6 7 11 8 12 0
0 10 11 8 2 14 6 5 14 11 4 0
0 12 6 7 13 11 2 10 4 7 8 0
0 3 9 11 1 5 6 3 12 8 8 0
0 10 9 14 4 1 2 13 12 13 7 0
0 5 6 1 10 6 7 5 1 5 13 0
0 5 14 12 14 10 9 13 13 2 9 0
0 4 1 8 11 1 9 2 3 5 7 0
0 8 6 14 4 11 10 12 8 3 7 0
0 0 0 0 0 0 0 0 0 0 0 0
