0 0 0 0 0 0 0 0 0 0 0 0
0 1 7 5 8 6 5 1 13 12 7 0
0 9 2 14 2 3 5 12 8 8 13 0
0 6 10 14 5 1 2 4 4 6 12 0
0 11 13 12 1 10 3 14 6 12 8 0
0 3 3 14 1 1 2 14 6 10 14 0
0 11 2 8 5 9 12 5 11 9 10 0
0 4 3 1 13 4 12 1 11 7 3 0
0 4 13 2 7 8 7 13 10 9 11 0
0 4 6 11 9 14 10 7 13 10 9 0
0 5 6 10 9 13 2 8 12 8 7 0
0 0 0 0 0 0 0 0 0 0 0 0
