0 0 0 0 0 0 0 0 0 0 0 0
0 6 9 11 8 10 5 2 7 1 5 0
0 2 12 8 4 14 2 7 12 4 14 0
0 10 3 13 7 14 4 11 5 9 14 0
0 9 14 8 9 3 1 3 13 6 8 0
0 4 10 11 2 6 12 13 6 13 11 0
0 13 9 7 4 12 4 11 12 1 10 0
0 8 6 7 3 1 9 1 3 1 2 0
0 10 5 8 1 5 10 13 6 5 7 0
0 9 11 3 5 6 11 10 12 12 2 0
0 7 2 2 10 14 4 13 8 7 8 0
0 0 0 0 0 0 0 0 0 0 0 0
