0 0 0 0 0 0 0 0 0 0 0 0
0 1 7 2 8 3 9 4 10 5 11 0
0 6 12 13 14 1 7 2 8 3 9 0
0 4 10 5 11 6 12 13 14 1 7 0
0 2 8 3 9 4 10 5 11 6 12 0
0 13 14 1 7 2 8 3 9 4 10 0
0 5 11 6 12 13 14 1 7 2 8 0
0 3 9 4 10 5 11 6 12 13 14 0
0 1 7 13 14 2 8 6 12 3 9 0
0 4 10 5 11 1 7 13 14 2 8 0
0 6 12 3 9 4 10 5 11 1 7 0
0 0 0 0 0 0 0 0 0 0 0 0
