0 0 0 0 0 0 0 0 0 0 0 0
0 11 5 3 4 9 4 11 5 3 4 0
0 8 11 11 5 10 3 6 13 10 12 0
0 5 2 2 12 6 7 6 4 12 7 0
0 3 9 14 3 6 8 13 14 9 9 0
0 4 8 13 10 2 2 1 13 4 14 0
0 11 8 12 5 14 10 9 11 9 1 0
0 1 13 12 7 10 3 1 7 14 8 0
0 13 12 7 10 14 2 12 14 12 2 0
0 6 7 10 1 6 1 13 1 10 1 0
0 6 2 9 5 8 14 2 8 8 7 0
0 0 0 0 0 0 0 0 0 0 0 0
