0 0 0 0 0 0 0 0 0 0 0 0
0 11 13 5 14 10 5 9 6 3 1 0
0 13 10 12 13 2 6 14 14 1 11 0
0 2 10 11 5 11 1 12 7 8 9 0
0 1 6 1 12 2 5 10 3 6 8 0
0 1 3 12 7 4 6 4 10 14 3 0
0 8 12 14 2 13 1 5 9 1 14 0
0 12 7 10 13 9 4 9 7 6 5 0
0 12 8 4 4 2 4 9 8 3 11 0
0 2 13 8 7 11 3 4 10 8 5 0
0 7 12 6 8 14 9 7 5 2 13 0
0 0 0 0 0 0 0 0 0 0 0 0
