0 0 0 0 0 0 0 0 0 0 0 0
0 1 4 2 5 3 6 7 10 8 11 0
0 9 12 13 14 1 4 2 5 3 6 0
0 7 10 8 11 9 12 13 14 1 4 0
0 2 5 3 6 7 10 8 11 9 12 0
0 13 14 1 4 2 5 3 6 7 10 0
0 8 11 9 12 13 14 1 4 2 5 0
0 3 6 7 10 8 11 9 12 13 14 0
0 1 4 13 14 2 5 9 12 3 6 0
0 7 10 8 11 1 4 13 14 2 5 0
0 9 12 3 6 7 10 8 11 1 4 0
0 0 0 0 0 0 0 0 0 0 0 0
