0 0 0 0 0 0 0 0 0 0 0 0
0 2 10 9 14 8 2 1 12 10 3 0
0 13 12 2 11 12 3 8 9 4 11 0
0 5 1 8 6 6 2 9 4 10 7 0
0 9 13 11 12 13 13 3 8 2 3 0
0 14 4 14 7 11 10 7 12 13 14 0
0 8 4 6 5 1 5 14 9 8 4 0
0 7 11 3 5 4 1 10 6 1 1 0
0 7 14 12 6 6 2 11 7 9 5 0
0 1 5 10 10 9 5 8 3 13 6 0
0 1 4 4 12 11 13 7 2 8 6 0
0 0 0 0 0 0 0 0 0 0 0 0
