0 0 0 0 0 0 0 0 0 0 0 0
0 11 3 3 4 3 3 8 12 11 4 0
0 13 1 14 10 7 2 11 1 14 1 0
0 8 8 4 14 1 7 2 11 6 9 0
0 1 7 9 2 12 5 6 11 2 13 0
0 12 2 13 1 5 6 9 6 6 8 0
0 7 4 13 5 4 4 13 14 10 12 0
0 12 6 7 2 4 3 9 10 7 13 0
0 10 14 5 12 5 1 9 2 8 9 0
0 10 10 6 5 8 13 7 10 9 5 0
0 9 14 3 8 12 11 2 6 5 12 0
0 0 0 0 0 0 0 0 0 0 0 0
