0 0 0 0 0 0 0 0 0 0 0 0
0 12 5 7 4 14 3 7 8 2 11 0
0 8 14 14 14 4 10 8 12 4 1 0
0 10 5 6 9 11 6 5 3 2 2 0
0 3 11 2 13 3 5 4 4 6 10 0
0 10 7 12 12 2 1 12 5 1 10 0
0 13 3 8 13 6 13 1 11 9 14 0
0 7 9 9 9 5 7 6 13 13 1 0
0 12 8 11 10 1 9 1 6 9 4 0
0 5 10 2 2 8 14 11 8 11 13 0
0 12 7 4 13 3 9 12 6 14 10 0
0 0 0 0 0 0 0 0 0 0 0 0
