0 0 0 0 0 0 0 0 0 0 0 0
0 6 7 2 12 11 9 10 11 8 5 0
0 4 2 1 12 3 5 4 6 5 2 0
0 1 12 1 13 4 10 9 2 4 8 0
0 3 13 6 5 3 6 12 5 10 9 0
0 3 7 11 11 14 1 8 8 13 14 0
0 6 7 10 2 2 11 13 4 8 7 0
0 10 13 10 9 11 6 1 14 9 9 0
0 8 12 7 12 14 14 1 13 14 3 0
0 3 5 5 2 12 10 7 11 9 6 0
0 4 13 1 8 8 13 14 7 10 1 0
0 0 0 0 0 0 0 0 0 0 0 0
