0 0 0 0 0 0 0 0 0 0 0 0
0 1 5 9 13 1 5 9 13 2 6 0
0 7 11 11 7 2 6 8 12 8 12 0
0 3 7 10 14 3 7 10 14 1 5 0
0 9 13 2 6 9 13 2 6 7 11 0
0 8 12 3 7 8 12 3 7 10 14 0
0 1 5 10 14 1 5 10 14 9 13 0
0 2 6 7 11 2 6 7 11 8 12 0
0 3 7 1 5 3 7 1 5 2 6 0
0 9 13 8 12 9 13 8 12 3 7 0
0 10 14 2 6 10 14 2 6 1 5 0
0 0 0 0 0 0 0 0 0 0 0 0
