0 0 0 0 0 0 0 0 0 0 0 0
0 2 10 11 2 6 11 4 5 1 3 0
0 1 12 9 2 10 1 5 10 13 13 0
0 7 5 3 6 10 1 9 8 2 1 0
0 1 6 6 8 8 7 1 12 4 4 0
0 7 14 11 4 3 2 7 9 6 13 0
0 14 12 11 9 14 12 5 10 8 3 0
0 12 3 13 14 6 9 8 13 9 7 0
0 5 14 4 5 8 2 14 13 11 10 0
0 7 11 5 8 9 12 4 14 4 3 0
0 6 1 2 10 12 3 9 13 7 7 0
0 0 0 0 0 0 0 0 0 0 0 0
