0 0 0 0 0 0 0 0 0 0 0 0
0 13 10 4 3 13 12 1 3 13 7 0
0 12 9 7 4 10 3 13 6 1 4 0
0 1 1 2 5 11 14 14 6 10 10 0
0 11 8 4 10 2 2 4 14 14 7 0
0 4 7 3 2 6 9 9 9 2 11 0
0 11 8 5 14 11 8 13 1 12 3 0
0 12 8 11 6 3 5 13 5 7 10 0
0 1 10 5 6 12 14 9 2 8 7 0
0 8 12 8 12 1 5 1 9 7 9 0
0 6 5 11 6 11 8 4 12 14 2 0
0 0 0 0 0 0 0 0 0 0 0 0
