0 0 0 0 0 0 0 0 0 0 0 0
0 1 11 2 12 3 13 4 14 5 1 0
0 6 2 7 3 8 4 9 5 10 6 0
0 11 7 12 8 13 9 14 10 1 2 0
0 3 11 4 12 5 13 6 14 7 1 0
0 8 2 9 3 10 4 1 5 2 6 0
0 7 8 3 9 4 10 5 1 6 2 0
0 11 12 7 13 8 14 9 1 10 2 0
0 3 4 11 5 12 6 13 7 14 8 0
0 9 10 1 9 2 10 3 1 4 2 0
0 5 6 7 3 8 4 9 5 10 6 0
0 0 0 0 0 0 0 0 0 0 0 0
