0 0 0 0 0 0 0 0 0 0 0 0
0 3 14 6 5 14 4 13 4 7 8 0
0 1 2 7 4 1 9 2 14 12 13 0
0 10 9 8 5 9 8 7 5 6 13 0
0 14 1 12 1 10 11 12 6 11 12 0
0 4 1 2 9 3 4 11 8 12 5 0
0 7 13 8 4 13 10 6 2 3 10 0
0 3 10 13 14 7 1 8 3 14 9 0
0 5 5 11 11 7 10 12 6 2 11 0
0 2 6 11 10 2 3 9 1 12 8 0
0 13 5 10 6 8 8 1 2 3 4 0
0 0 0 0 0 0 0 0 0 0 0 0
