0 0 0 0 0 0 0 0 0 0 0 0
0 1 3 5 7 2 4 6 8 9 11 0
0 10 12 13 14 1 3 5 7 2 4 0
0 6 8 9 11 10 12 13 14 1 3 0
0 5 7 2 4 6 8 9 11 10 12 0
0 13 14 1 3 5 7 2 4 6 8 0
0 9 11 10 12 13 14 1 3 5 7 0
0 2 4 6 8 9 11 10 12 13 14 0
0 1 3 13 14 5 7 10 12 2 4 0
0 6 8 9 11 1 3 13 14 5 7 0
0 10 12 2 4 6 8 9 11 1 3 0
0 0 0 0 0 0 0 0 0 0 0 0
