0 0 0 0 0 0 0 0 0 0 0 0
0 1 2 7 13 3 4 8 14 5 6 0
0 9 10 11 12 1 2 7 13 3 4 0
0 8 14 5 6 9 10 11 12 1 2 0
0 7 13 3 4 8 14 5 6 9 10 0
0 11 12 1 2 7 13 3 4 8 14 0
0 5 6 9 10 11 12 1 2 7 13 0
0 3 4 8 14 5 6 9 10 11 12 0
0 1 2 5 6 7 13 9 10 8 14 0
0 11 12 3 4 1 2 5 6 7 13 0
0 9 10 8 14 11 12 3 4 1 2 0
0 0 0 0 0 0 0 0 0 0 0 0
