0 0 0 0 0 0 0 0 0 0 0 0
0 1 3 5 7 9 11 13 2 4 6 0
0 1 3 5 7 9 11 13 2 4 6 0
0 8 10 12 14 1 3 5 7 9 11 0
0 8 10 12 14 1 3 5 7 9 11 0
0 13 2 4 6 8 10 12 14 1 3 0
0 13 2 4 6 8 10 12 14 1 3 0
0 5 7 9 11 13 2 4 6 8 10 0
0 5 7 9 11 13 2 4 6 8 10 0
0 12 14 1 3 5 7 9 11 13 2 0
0 12 14 1 3 5 7 9 11 13 2 0
0 0 0 0 0 0 0 0 0 0 0 0
