0 0 0 0 0 0 0 0 0 0 0 0
0 6 1 12 11 4 4 14 5 14 3 0
0 9 2 11 5 13 13 1 11 9 7 0
0 4 14 13 11 6 9 8 8 10 7 0
0 1 7 8 2 6 10 12 2 6 1 0
0 5 4 3 5 11 4 10 3 14 6 0
0 12 14 3 9 6 7 2 3 5 2 0
0 8 13 7 8 5 4 2 10 13 10 0
0 12 12 8 3 7 9 10 12 1 2 0
0 13 9 5 1 6 13 1 12 4 10 0
0 14 10 11 7 1 11 2 8 14 8 0
0 0 0 0 0 0 0 0 0 0 0 0
