0 0 0 0 0 0 0 0 0 0 0 0
0 3 1 4 9 14 13 2 9 6 6 0
0 3 10 13 14 4 12 11 4 8 4 0
0 14 10 5 7 1 3 3 13 12 11 0
0 5 3 2 9 7 9 2 8 6 1 0
0 4 11 5 5 10 13 8 2 11 10 0
0 7 6 7 8 9 2 14 6 10 1 0
0 7 5 11 10 1 1 14 8 5 11 0
0 12 12 1 12 3 14 12 8 2 13 0
0 13 8 2 4 6 7 10 11 4 9 0
0 6 7 5 9 12 8 13 1 3 10 0
0 0 0 0 0 0 0 0 0 0 0 0
