0 0 0 0 0 0 0 0 0 0 0 0
0 1 7 12 14 1 7 12 14 3 8 0
0 6 10 10 6 3 8 9 11 9 11 0
0 2 4 5 13 2 4 5 13 1 7 0
0 12 14 3 8 12 14 3 8 6 10 0
0 9 11 2 4 9 11 2 4 5 13 0
0 1 7 5 13 1 7 5 13 12 14 0
0 3 8 6 10 3 8 6 10 9 11 0
0 2 4 1 7 2 4 1 7 3 8 0
0 12 14 9 11 12 14 9 11 2 4 0
0 5 13 3 8 5 13 3 8 1 7 0
0 0 0 0 0 0 0 0 0 0 0 0
