0 0 0 0 0 0 0 0 0 0 0 0
0 1 7 13 2 8 14 3 9 1 10 0
0 4 11 2 7 13 3 8 14 4 9 0
0 5 12 4 11 5 12 1 7 13 2 0
0 8 14 3 9 10 1 7 13 2 8 0
0 14 4 9 10 5 12 4 11 1 7 0
0 13 2 8 14 3 9 10 5 12 4 0
0 11 5 12 1 7 13 2 8 14 3 0
0 9 10 4 11 5 12 1 7 13 2 0
0 8 14 3 9 10 4 11 5 12 1 0
0 7 13 2 8 14 3 9 10 4 11 0
0 0 0 0 0 0 0 0 0 0 0 0
