0 0 0 0 0 0 0 0 0 0 0 0
0 10 4 2 8 6 6 8 13 7 10 0
0 2 3 3 11 2 14 11 14 1 5 0
0 7 8 6 4 12 12 13 9 5 13 0
0 1 11 3 1 6 14 9 1 12 6 0
0 9 13 11 3 3 14 11 5 5 10 0
0 12 7 9 7 13 14 1 4 7 1 0
0 8 5 2 14 6 5 10 4 7 4 0
0 12 2 1 13 10 8 4 9 12 6 0
0 11 9 2 11 13 9 2 12 1 10 0
0 12 10 8 5 4 8 7 3 3 6 0
0 0 0 0 0 0 0 0 0 0 0 0
