0 0 0 0 0 0 0 0 0 0 0 0
0 1 4 2 5 3 6 11 12 13 14 0
0 7 8 9 10 1 4 2 5 3 6 0
0 11 12 13 14 7 8 9 10 1 4 0
0 2 5 3 6 11 12 13 14 7 8 0
0 9 10 1 4 2 5 3 6 11 12 0
0 13 14 7 8 9 10 1 4 2 5 0
0 3 6 11 12 13 14 7 8 9 10 0
0 1 4 13 14 2 5 9 10 3 6 0
0 7 8 1 4 13 14 2 5 11 12 0
0 9 10 3 6 7 8 1 4 13 14 0
0 0 0 0 0 0 0 0 0 0 0 0
