0 0 0 0 0 0 0 0 0 0 0 0
0 5 11 6 2 6 1 14 14 9 3 0
0 9 13 1 1 6 12 2 11 3 1 0
0 4 5 5 12 3 11 7 10 3 14 0
0 8 7 13 2 10 12 14 6 4 8 0
0 2 12 6 9 10 7 8 12 2 11 0
0 9 14 10 11 5 13 14 1 8 8 0
0 1 11 10 7 9 2 9 13 8 13 0
0 7 12 4 4 14 5 3 10 2 6 0
0 13 10 4 4 7 12 8 12 13 10 0
0 5 3 6 8 13 9 2 7 11 1 0
0 0 0 0 0 0 0 0 0 0 0 0
