0 0 0 0 0 0 0 0 0 0 0 0
0 9 2 11 8 3 8 7 1 1 6 0
0 3 4 11 5 9 14 12 11 4 13 0
0 6 14 13 3 8 1 13 11 6 8 0
0 14 5 12 5 1 13 4 11 14 14 0
0 3 13 9 12 4 1 7 3 6 13 0
0 2 2 1 13 1 10 1 9 10 12 0
0 6 4 10 7 2 7 6 5 2 4 0
0 2 10 5 9 10 12 5 8 7 10 0
0 12 12 3 6 8 14 10 8 5 9 0
0 14 7 11 2 12 9 4 13 10 5 0
0 0 0 0 0 0 0 0 0 0 0 0
