0 0 0 0 0 0 0 0 0 0 0 0
0 1 9 2 10 3 11 4 12 5 13 0
0 6 14 1 9 2 10 3 11 4 12 0
0 5 13 6 14 1 9 2 10 3 11 0
0 4 12 5 13 6 14 1 9 2 10 0
0 3 11 4 12 5 13 6 14 1 9 0
0 2 10 3 11 4 12 5 13 6 14 0
0 1 9 2 10 3 11 4 12 5 13 0
0 6 14 1 9 2 10 3 11 4 12 0
0 5 13 6 14 1 9 2 10 3 11 0
0 4 12 5 13 6 14 1 9 2 10 0
0 0 0 0 0 0 0 0 0 0 0 0
