0 0 0 0 0 0 0 0 0 0 0 0
0 1 8 1 8 2 9 2 9 3 10 0
0 3 10 4 11 4 11 5 12 5 12 0
0 6 13 6 13 7 14 7 14 1 8 0
0 2 9 3 10 3 10 4 11 4 11 0
0 5 12 5 12 6 13 6 13 7 14 0
0 7 14 1 8 1 8 2 9 2 9 0
0 4 11 5 12 5 12 6 13 6 13 0
0 7 14 7 14 1 8 1 8 2 9 0
0 3 10 3 10 4 11 4 11 5 12 0
0 6 13 6 13 7 14 7 14 1 8 0
0 0 0 0 0 0 0 0 0 0 0 0
