0 0 0 0 0 0 0 0 0 0 0 0
0 8 13 1 10 6 5 4 4 9 2 0
0 4 12 6 14 3 11 6 12 2 3 0
0 5 3 2 10 13 10 5 9 10 1 0
0 13 7 12 3 8 14 12 1 9 14 0
0 14 4 11 11 4 5 14 12 10 6 0
0 2 14 3 12 5 9 13 1 7 2 0
0 8 5 8 9 2 7 6 7 8 5 0
0 11 8 7 6 6 11 13 10 11 13 0
0 13 9 12 7 2 4 1 1 3 8 0
0 9 1 7 4 10 14 5 11 3 8 0
0 0 0 0 0 0 0 0 0 0 0 0
