0 0 0 0 0 0 0 0 0 0 0 0
0 3 7 10 1 6 4 8 14 2 6 0
0 13 11 11 6 5 13 8 1 4 10 0
0 1 2 13 5 3 2 9 3 1 11 0
0 11 1 3 10 6 3 4 4 11 1 0
0 1 6 5 2 9 12 8 8 13 7 0
0 8 14 4 10 9 1 11 5 3 13 0
0 12 14 14 6 5 7 7 12 12 4 0
0 2 12 8 4 9 10 9 5 2 14 0
0 13 10 2 7 14 12 13 6 10 2 0
0 8 12 9 14 5 7 10 9 7 4 0
0 0 0 0 0 0 0 0 0 0 0 0
