0 0 0 0 0 0 0 0 0 0 0 0
0 3 14 2 14 9 10 1 11 10 12 0
0 2 6 5 1 3 3 14 13 10 11 0
0 12 3 12 8 8 5 5 13 3 6 0
0 1 7 9 1 11 12 7 2 6 11 0
0 11 13 12 14 4 13 14 6 4 4 0
0 1 10 8 11 8 1 2 8 13 9 0
0 5 7 2 7 4 12 14 10 6 1 0
0 10 6 9 7 9 8 5 2 11 5 0
0 7 9 4 4 12 10 9 4 6 13 0
0 1 2 13 8 10 5 6 13 7 2 0
0 0 0 0 0 0 0 0 0 0 0 0
