0 0 0 0 0 0 0 0 0 0 0 0
0 3 5 10 12 8 2 11 3 10 14 0
0 9 10 4 6 11 11 7 8 7 14 0
0 3 8 7 13 12 6 8 3 3 8 0
0 4 1 11 4 12 13 13 14 4 11 0
0 5 2 1 1 9 4 2 13 14 14 0
0 4 2 2 10 8 14 6 6 1 10 0
0 6 7 10 3 13 9 12 12 9 12 0
0 1 5 11 7 5 12 2 5 7 1 0
0 9 6 13 2 9 13 6 8 9 5 0
0 1 5 5 7 8 10 11 4 3 3 0
0 0 0 0 0 0 0 0 0 0 0 0
