0 0 0 0 0 0 0 0 0 0 0 0
0 1 3 6 9 1 3 6 9 2 4 0
0 7 10 10 7 2 4 8 11 8 11 0
0 5 12 13 14 5 12 13 14 1 3 0
0 6 9 2 4 6 9 2 4 7 10 0
0 8 11 5 12 8 11 5 12 13 14 0
0 1 3 13 14 1 3 13 14 6 9 0
0 2 4 7 10 2 4 7 10 8 11 0
0 5 12 1 3 5 12 1 3 2 4 0
0 6 9 8 11 6 9 8 11 5 12 0
0 13 14 2 4 13 14 2 4 1 3 0
0 0 0 0 0 0 0 0 0 0 0 0
