0 0 0 0 0 0 0 0 0 0 0 0
0 2 5 2 7 9 14 12 7 11 8 0
0 11 3 13 6 4 6 2 4 6 3 0
0 14 10 3 13 12 14 1 1 7 8 0
0 9 11 10 10 4 1 13 3 6 10 0
0 10 12 1 11 13 12 1 8 12 7 0
0 8 5 8 9 3 5 4 4 4 13 0
0 9 5 11 2 5 2 14 5 14 10 0
0 12 6 7 14 9 7 9 13 3 6 0
0 1 8 10 2 8 5 11 1 1 4 0
0 14 12 8 11 9 10 13 12 4 7 0
0 0 0 0 0 0 0 0 0 0 0 0
