0 0 0 0 0 0 0 0 0 0 0 0
0 1 6 11 14 1 6 11 14 2 7 0
0 8 12 12 8 2 7 9 13 9 13 0
0 3 5 10 11 3 5 10 11 1 6 0
0 11 14 2 7 11 14 2 7 8 12 0
0 9 13 3 5 9 13 3 5 10 11 0
0 1 6 10 11 1 6 10 11 11 14 0
0 2 7 8 12 2 7 8 12 9 13 0
0 3 5 1 6 3 5 1 6 2 7 0
0 11 14 9 13 11 14 9 13 3 5 0
0 10 11 2 7 10 11 2 7 1 6 0
0 0 0 0 0 0 0 0 0 0 0 0
