0 0 0 0 0 0 0 0 0 0 0 0
0 9 2 14 1 4 4 10 8 10 1 0
0 8 13 1 14 2 3 10 1 12 6 0
0 1 5 1 2 9 3 11 3 2 14 0
0 11 13 6 8 8 6 12 14 13 5 0
0 14 2 5 3 9 11 1 11 7 12 0
0 5 13 5 3 10 12 7 11 5 10 0
0 4 12 10 6 7 6 5 8 14 9 0
0 12 7 9 4 12 4 11 7 8 2 0
0 4 6 11 2 13 4 13 9 9 7 0
0 10 12 6 8 8 14 13 3 5 2 0
0 0 0 0 0 0 0 0 0 0 0 0
