0 0 0 0 0 0 0 0 0 0 0 0
0 4 12 11 14 1 3 5 14 6 5 0
0 10 5 14 4 1 13 6 11 13 12 0
0 4 9 3 11 2 13 7 12 14 2 0
0 9 7 4 13 7 8 1 3 8 12 0
0 14 6 5 2 11 9 14 11 3 6 0
0 5 1 10 13 6 4 3 2 10 12 0
0 7 1 8 9 9 11 13 2 10 5 0
0 5 1 10 14 8 2 12 1 1 2 0
0 8 7 10 12 9 8 6 13 7 8 0
0 6 12 10 7 3 5 4 11 9 8 0
0 0 0 0 0 0 0 0 0 0 0 0
