0 0 0 0 0 0 0 0 0 0 0 0
0 8 6 12 4 2 14 6 5 2 12 0
0 9 2 11 11 3 2 9 6 3 12 0
0 3 11 10 7 1 3 3 10 14 10 0
0 13 11 14 4 8 1 4 4 2 13 0
0 4 12 14 6 1 2 11 10 4 13 0
0 5 12 14 9 1 7 12 3 5 12 0
0 8 6 7 8 13 9 1 14 1 11 0
0 10 5 8 7 13 10 12 5 7 10 0
0 14 7 1 5 9 13 5 1 9 7 0
0 6 5 13 8 8 6 14 10 9 4 0
0 0 0 0 0 0 0 0 0 0 0 0
