0 0 0 0 0 0 0 0 0 0 0 0
0 10 12 2 4 2 1 14 12 2 12 0
0 5 13 7 12 9 8 5 13 11 4 0
0 13 5 1 2 5 3 2 1 6 6 0
0 1 10 8 8 10 11 1 8 3 10 0
0 9 3 7 13 11 12 6 9 9 7 0
0 14 14 9 4 11 13 14 6 14 3 0
0 4 11 6 7 11 5 13 7 13 7 0
0 12 14 10 10 8 4 6 1 8 4 0
0 3 8 6 12 2 7 9 5 2 1 0
0 5 11 4 3 9 3 10 7 1 14 0
0 0 0 0 0 0 0 0 0 0 0 0
