0 0 0 0 0 0 0 0 0 0 0 0
0 10 13 10 2 13 3 1 14 3 6 0
0 1 11 7 5 2 1 5 12 6 9 0
0 5 2 8 1 10 6 2 9 11 1 0
0 4 4 11 12 1 12 6 10 9 7 0
0 6 7 11 3 8 7 1 12 13 10 0
0 5 13 1 14 4 3 4 10 9 7 0
0 14 8 8 2 3 4 5 13 8 7 0
0 9 14 11 11 4 14 13 9 12 8 0
0 12 8 2 12 7 9 14 10 5 6 0
0 6 13 5 8 3 12 2 4 7 10 0
0 0 0 0 0 0 0 0 0 0 0 0
