0 0 0 0 0 0 0 0 0 0 0 0
0 6 12 11 10 1 6 11 9 8 2 0
0 6 2 9 10 3 8 7 8 5 13 0
0 7 1 8 3 12 5 6 13 11 13 0
0 12 1 1 5 12 9 12 12 3 2 0
0 9 2 4 4 1 4 14 4 4 10 0
0 2 8 7 1 5 10 14 10 1 7 0
0 2 5 13 6 4 11 13 11 10 7 0
0 11 14 14 2 13 9 14 13 14 9 0
0 8 3 10 10 14 5 13 3 3 8 0
0 1 12 14 7 5 9 6 3 12 2 0
0 0 0 0 0 0 0 0 0 0 0 0
