0 0 0 0 0 0 0 0 0 0 0 0
0 1 2 5 8 1 2 5 8 3 6 0
0 9 12 12 9 3 6 10 13 10 13 0
0 4 7 11 14 4 7 11 14 1 2 0
0 5 8 3 6 5 8 3 6 9 12 0
0 10 13 4 7 10 13 4 7 11 14 0
0 1 2 11 14 1 2 11 14 5 8 0
0 3 6 9 12 3 6 9 12 10 13 0
0 4 7 1 2 4 7 1 2 3 6 0
0 5 8 10 13 5 8 10 13 4 7 0
0 11 14 3 6 11 14 3 6 1 2 0
0 0 0 0 0 0 0 0 0 0 0 0
