0 0 0 0 0 0 0 0 0 0 0 0
0 8 5 8 13 4 7 4 5 10 10 0
0 2 4 1 2 3 6 10 13 13 9 0
0 7 1 9 12 11 13 1 14 14 5 0
0 9 11 10 4 13 6 7 13 1 1 0
0 11 8 8 14 12 6 9 9 4 1 0
0 3 10 2 6 5 3 2 14 8 2 0
0 3 7 10 3 5 4 12 8 6 4 0
0 12 7 11 2 14 12 9 1 14 11 0
0 9 6 12 12 6 12 5 11 13 10 0
0 5 10 14 8 13 2 7 7 11 12 0
0 0 0 0 0 0 0 0 0 0 0 0
