0 0 0 0 0 0 0 0 0 0 0 0
0 1 3 2 4 9 11 10 12 13 14 0
0 5 7 6 8 1 3 2 4 9 11 0
0 10 12 13 14 5 7 6 8 1 3 0
0 2 4 9 11 10 12 13 14 5 7 0
0 6 8 1 3 2 4 9 11 10 12 0
0 13 14 5 7 6 8 1 3 2 4 0
0 9 11 10 12 13 14 5 7 6 8 0
0 1 3 13 14 2 4 10 12 9 11 0
0 5 7 1 3 13 14 2 4 6 8 0
0 10 12 9 11 5 7 1 3 13 14 0
0 0 0 0 0 0 0 0 0 0 0 0
