0 0 0 0 0 0 0 0 0 0 0 0
0 1 6 2 7 3 8 4 9 5 10 0
0 11 12 13 14 1 6 2 7 3 8 0
0 4 9 5 10 11 12 13 14 1 6 0
0 2 7 3 8 4 9 5 10 11 12 0
0 13 14 1 6 2 7 3 8 4 9 0
0 5 10 11 12 13 14 1 6 2 7 0
0 3 8 4 9 5 10 11 12 13 14 0
0 1 6 13 14 2 7 11 12 3 8 0
0 4 9 5 10 1 6 13 14 2 7 0
0 11 12 3 8 4 9 5 10 1 6 0
0 0 0 0 0 0 0 0 0 0 0 0
