0 0 0 0 0 0 0 0 0 0 0 0
0 1 2 4 7 11 14 10 6 3 8 0
0 3 5 8 12 1 2 4 7 11 14 0
0 6 9 10 13 3 5 8 12 1 2 0
0 4 7 11 14 6 9 10 13 3 5 0
0 8 12 1 2 4 7 11 14 6 9 0
0 10 13 3 5 8 12 1 2 4 7 0
0 11 14 6 9 10 13 3 5 8 12 0
0 1 2 4 7 11 14 6 9 10 13 0
0 3 5 8 12 1 2 4 7 11 14 0
0 6 9 10 13 3 5 8 12 1 2 0
0 0 0 0 0 0 0 0 0 0 0 0
