0 0 0 0 0 0 0 0 0 0 0 0
0 1 9 10 11 14 7 2 1 14 8 0
0 7 11 4 4 10 6 3 11 10 9 0
0 11 2 9 13 3 3 9 7 13 5 0
0 3 13 5 5 10 14 7 8 9 3 0
0 13 14 14 1 4 6 2 2 10 6 0
0 13 2 8 5 4 10 5 7 11 4 0
0 12 4 8 8 1 1 11 12 13 12 0
0 6 7 2 2 1 12 6 12 3 6 0
0 9 8 9 4 12 7 5 6 10 8 0
0 10 11 1 5 14 12 13 7 6 14 0
0 0 0 0 0 0 0 0 0 0 0 0
