0 0 0 0 0 0 0 0 0 0 0 0
0 1 2 3 4 5 11 12 13 14 6 0
0 7 8 9 10 1 2 3 4 5 11 0
0 12 13 14 6 7 8 9 10 1 2 0
0 3 4 5 11 12 13 14 6 7 8 0
0 9 10 1 2 3 4 5 11 12 13 0
0 14 6 7 8 9 10 1 2 3 4 0
0 5 11 12 13 14 6 7 8 9 10 0
0 1 2 14 6 3 4 9 10 5 11 0
0 12 13 7 8 1 2 14 6 3 4 0
0 9 10 5 11 12 13 7 8 1 2 0
0 0 0 0 0 0 0 0 0 0 0 0
