0 0 0 0 0 0 0 0 0 0 0 0
0 1 5 9 13 2 6 10 14 3 7 0
0 1 5 9 13 2 6 10 14 3 7 0
0 4 8 11 12 1 5 9 13 2 6 0
0 4 8 11 12 1 5 9 13 2 6 0
0 10 14 3 7 4 8 11 12 1 5 0
0 10 14 3 7 4 8 11 12 1 5 0
0 9 13 2 6 10 14 3 7 4 8 0
0 9 13 2 6 10 14 3 7 4 8 0
0 11 12 1 5 9 13 2 6 10 14 0
0 11 12 1 5 9 13 2 6 10 14 0
0 0 0 0 0 0 0 0 0 0 0 0
