0 0 0 0 0 0 0 0 0 0 0 0
0 1 14 2 13 3 12 4 11 5 10 0
0 1 14 2 13 3 12 4 11 5 10 0
0 6 9 7 8 1 14 2 13 3 12 0
0 6 9 7 8 1 14 2 13 3 12 0
0 4 11 5 10 6 9 7 8 1 14 0
0 4 11 5 10 6 9 7 8 1 14 0
0 2 13 3 12 4 11 5 10 6 9 0
0 2 13 3 12 4 11 5 10 6 9 0
0 7 8 1 14 2 13 3 12 4 11 0
0 7 8 1 14 2 13 3 12 4 11 0
0 0 0 0 0 0 0 0 0 0 0 0
