0 0 0 0 0 0 0 0 0 0 0 0
0 1 14 4 6 5 7 8 4 3 6 0
0 9 5 1 5 9 11 14 5 1 5 0
0 7 1 8 3 2 12 8 8 2 13 0
0 11 6 11 12 2 11 10 11 2 4 0
0 8 2 7 2 1 1 10 4 9 10 0
0 3 10 4 6 7 6 6 14 14 3 0
0 12 7 12 3 4 13 10 3 8 13 0
0 3 13 9 9 11 12 10 12 8 14 0
0 2 12 13 10 13 9 6 13 14 1 0
0 14 5 7 12 4 10 11 1 8 13 0
0 0 0 0 0 0 0 0 0 0 0 0
