0 0 0 0 0 0 0 0 0 0 0 0
0 1 14 3 12 5 10 7 8 9 11 0
0 1 14 3 12 5 10 7 8 9 11 0
0 2 13 4 11 6 9 1 14 3 12 0
0 2 13 4 11 6 9 1 14 3 12 0
0 5 10 7 8 2 13 4 11 6 9 0
0 5 10 7 8 2 13 4 11 6 9 0
0 1 14 3 12 5 10 7 8 2 13 0
0 1 14 3 12 5 10 7 8 2 13 0
0 4 11 6 9 1 14 3 12 5 10 0
0 4 11 6 9 1 14 3 12 5 10 0
0 0 0 0 0 0 0 0 0 0 0 0
