0 0 0 0 0 0 0 0 0 0 0 0
0 1 3 2 6 5 9 8 12 11 14 0
0 1 3 2 6 5 9 8 12 11 14 0
0 4 7 10 13 1 3 2 6 5 9 0
0 4 7 10 13 1 3 2 6 5 9 0
0 8 12 11 14 4 7 10 13 1 3 0
0 8 12 11 14 4 7 10 13 1 3 0
0 2 6 5 9 8 12 11 14 4 7 0
0 2 6 5 9 8 12 11 14 4 7 0
0 10 13 1 3 2 6 5 9 8 12 0
0 10 13 1 3 2 6 5 9 8 12 0
0 0 0 0 0 0 0 0 0 0 0 0
