0 0 0 0 0 0 0 0 0 0 0 0
0 1 12 9 6 1 11 8 6 1 4 0
0 11 5 14 7 13 9 11 2 3 7 0
0 12 4 12 4 3 4 1 3 8 3 0
0 13 9 1 13 11 14 2 8 9 14 0
0 8 7 10 2 14 6 5 14 7 4 0
0 10 12 10 1 13 13 10 10 12 5 0
0 3 2 8 7 5 7 9 5 6 11 0
0 6 10 4 12 11 2 14 2 14 6 0
0 2 9 8 5 11 5 6 10 12 8 0
0 13 7 12 4 9 3 13 3 8 10 0
0 0 0 0 0 0 0 0 0 0 0 0
