0 0 0 0 0 0 0 0 0 0 0 0
0 1 10 11 2 9 12 3 8 13 4 0
0 7 14 5 6 1 10 11 2 9 12 0
0 3 8 13 4 7 14 5 6 1 10 0
0 11 2 9 12 3 8 13 4 7 14 0
0 5 6 1 10 11 2 9 12 3 8 0
0 13 4 7 14 5 6 1 10 11 2 0
0 9 12 3 8 13 4 7 14 5 6 0
0 1 10 13 4 11 2 7 14 9 12 0
0 3 8 5 6 1 10 13 4 11 2 0
0 7 14 9 12 3 8 5 6 1 10 0
0 0 0 0 0 0 0 0 0 0 0 0
