0 0 0 0 0 0 0 0 0 0 0 0
0 1 2 5 6 9 10 13 14 3 4 0
0 1 2 5 6 9 10 13 14 3 4 0
0 7 8 11 12 1 2 5 6 9 10 0
0 7 8 11 12 1 2 5 6 9 10 0
0 13 14 3 4 7 8 11 12 1 2 0
0 13 14 3 4 7 8 11 12 1 2 0
0 5 6 9 10 13 14 3 4 7 8 0
0 5 6 9 10 13 14 3 4 7 8 0
0 11 12 1 2 5 6 9 10 13 14 0
0 11 12 1 2 5 6 9 10 13 14 0
0 0 0 0 0 0 0 0 0 0 0 0
