0 0 0 0 0 0 0 0 0 0 0 0
0 4 2 14 10 6 8 3 2 10 9 0
0 14 3 10 5 7 12 2 1 13 12 0
0 11 4 7 2 6 12 9 9 3 14 0
0 14 5 11 13 10 8 8 10 11 12 0
0 6 13 1 1 13 4 1 6 3 8 0
0 11 14 7 13 4 14 1 4 6 12 0
0 7 7 8 13 2 9 2 3 3 5 0
0 5 6 9 9 11 1 5 1 10 7 0
0 5 2 1 11 8 4 12 6 12 8 0
0 9 5 2 13 10 7 8 3 4 6 0
0 0 0 0 0 0 0 0 0 0 0 0
