0 0 0 0 0 0 0 0 0 0 0 0
0 1 6 11 2 7 12 3 8 13 4 0
0 1 6 11 2 7 12 3 8 13 4 0
0 9 14 5 10 1 6 11 2 7 12 0
0 9 14 5 10 1 6 11 2 7 12 0
0 3 8 13 4 9 14 5 10 1 6 0
0 3 8 13 4 9 14 5 10 1 6 0
0 11 2 7 12 3 8 13 4 9 14 0
0 11 2 7 12 3 8 13 4 9 14 0
0 5 10 1 6 11 2 7 12 3 8 0
0 5 10 1 6 11 2 7 12 3 8 0
0 0 0 0 0 0 0 0 0 0 0 0
