0 0 0 0 0 0 0 0 0 0 0 0
0 1 5 9 2 6 10 3 7 11 4 0
0 8 12 13 14 1 5 9 2 6 10 0
0 3 7 11 4 8 12 13 14 1 5 0
0 9 2 6 10 3 7 11 4 8 12 0
0 13 14 1 5 9 2 6 10 3 7 0
0 11 4 8 12 13 14 1 5 9 2 0
0 6 10 3 7 11 4 8 12 13 14 0
0 1 5 13 14 9 2 8 12 6 10 0
0 3 7 11 4 1 5 13 14 9 2 0
0 8 12 6 10 3 7 11 4 1 5 0
0 0 0 0 0 0 0 0 0 0 0 0
