0 0 0 0 0 0 0 0 0 0 0 0
0 11 7 9 4 5 10 13 6 12 14 0
0 8 14 9 3 7 4 11 3 4 12 0
0 9 8 5 11 3 14 1 5 1 2 0
0 14 1 7 12 5 2 11 8 6 14 0
0 12 1 3 1 7 6 5 9 10 4 0
0 10 8 13 9 1 10 3 6 8 13 0
0 11 2 13 13 2 14 4 12 7 9 0
0 8 6 5 6 4 12 2 11 2 10 0
0 7 10 2 6 13 10 1 12 5 9 0
0 3 4 10 7 8 8 9 5 14 6 0
0 0 0 0 0 0 0 0 0 0 0 0
