0 0 0 0 0 0 0 0 0 0 0 0
0 1 2 3 4 1 2 3 4 5 6 0
0 7 8 9 10 7 8 9 10 11 12 0
0 13 14 5 6 13 14 5 6 1 2 0
0 11 12 13 14 11 12 13 14 3 4 0
0 5 6 7 8 5 6 7 8 9 10 0
0 1 2 11 12 1 2 11 12 13 14 0
0 3 4 9 10 3 4 9 10 5 6 0
0 7 8 13 14 7 8 13 14 1 2 0
0 9 10 1 2 9 10 1 2 3 4 0
0 11 12 3 4 11 12 3 4 7 8 0
0 0 0 0 0 0 0 0 0 0 0 0
