0 0 0 0 0 0 0 0 0 0 0 0
0 5 13 1 4 6 5 11 10 7 13 0
0 11 3 10 4 6 4 9 7 3 14 0
0 1 3 7 14 6 1 4 12 13 1 0
0 11 8 9 12 10 6 12 2 1 7 0
0 4 11 3 1 5 1 2 4 8 2 0
0 9 6 12 2 3 9 10 14 9 14 0
0 9 5 5 13 8 3 8 7 8 13 0
0 12 6 2 7 2 12 11 14 10 8 0
0 2 13 14 10 10 13 8 9 12 5 0
0 7 11 10 1 5 14 8 4 9 12 0
0 0 0 0 0 0 0 0 0 0 0 0
