0 0 0 0 0 0 0 0 0 0 0 0
0 1 2 3 11 12 13 4 5 6 14 0
0 7 8 9 1 2 3 10 11 12 4 0
0 5 6 14 7 8 9 1 2 3 10 0
0 11 12 4 5 6 14 7 8 9 1 0
0 2 3 10 11 12 4 5 6 14 7 0
0 8 9 1 2 3 10 11 12 4 5 0
0 6 14 7 8 9 1 2 3 10 11 0
0 12 4 5 6 14 7 8 9 1 2 0
0 3 10 11 12 4 5 6 14 7 8 0
0 9 1 2 3 10 11 12 4 5 6 0
0 0 0 0 0 0 0 0 0 0 0 0
