0 0 0 0 0 0 0 0 0 0 0 0
0 1 8 14 2 7 13 3 6 12 4 0
0 5 11 1 8 14 2 7 13 3 6 0
0 12 4 5 11 1 8 14 2 7 13 0
0 3 6 12 4 5 11 1 8 14 2 0
0 7 13 3 6 12 4 5 11 1 8 0
0 14 2 7 13 3 6 12 4 5 11 0
0 1 8 14 2 7 13 3 6 12 4 0
0 5 11 1 8 14 2 7 13 3 6 0
0 12 4 5 11 1 8 14 2 7 13 0
0 3 6 12 4 5 11 1 8 14 2 0
0 0 0 0 0 0 0 0 0 0 0 0
