0 0 0 0 0 0 0 0 0 0 0 0
0 1 5 14 3 2 10 14 3 11 10 0
0 10 1 2 6 1 1 12 9 6 3 0
0 11 5 12 4 10 5 10 2 12 2 0
0 12 3 3 1 8 9 2 9 9 4 0
0 9 13 4 6 5 11 7 11 7 14 0
0 8 11 3 13 14 4 8 14 14 6 0
0 2 4 5 2 6 7 12 10 13 8 0
0 4 13 1 13 8 10 5 12 1 11 0
0 7 6 7 8 7 7 13 9 8 8 0
0 12 4 5 14 11 13 6 4 6 3 0
0 0 0 0 0 0 0 0 0 0 0 0
