0 0 0 0 0 0 0 0 0 0 0 0
0 13 11 6 11 10 7 12 6 9 9 0
0 4 12 11 11 7 13 8 7 3 13 0
0 9 6 3 12 8 9 13 2 10 14 0
0 14 4 1 8 1 2 2 12 7 8 0
0 2 1 14 5 1 3 14 5 10 1 0
0 10 8 12 6 6 14 9 4 8 7 0
0 4 3 5 10 4 5 3 3 12 4 0
0 13 1 7 9 11 2 10 5 5 6 0
0 2 2 8 14 8 13 6 4 11 1 0
0 1 4 10 12 5 9 12 3 7 10 0
0 0 0 0 0 0 0 0 0 0 0 0
