0 0 0 0 0 0 0 0 0 0 0 0
0 1 4 7 10 1 4 7 10 2 5 0
0 8 11 11 8 2 5 9 12 9 12 0
0 3 6 13 14 3 6 13 14 1 4 0
0 7 10 2 5 7 10 2 5 8 11 0
0 9 12 3 6 9 12 3 6 13 14 0
0 1 4 13 14 1 4 13 14 7 10 0
0 2 5 8 11 2 5 8 11 9 12 0
0 3 6 1 4 3 6 1 4 2 5 0
0 7 10 9 12 7 10 9 12 3 6 0
0 13 14 2 5 13 14 2 5 1 4 0
0 0 0 0 0 0 0 0 0 0 0 0
