0 0 0 0 0 0 0 0 0 0 0 0
0 7 3 2 5 3 2 14 2 9 4 0
0 3 8 10 1 14 4 13 12 2 4 0
0 5 14 1 12 3 13 13 2 6 7 0
0 4 7 1 9 11 12 1 8 10 12 0
0 8 12 11 4 7 11 3 4 5 6 0
0 14 11 9 5 12 10 11 8 9 13 0
0 1 7 8 14 13 6 14 6 5 6 0
0 2 13 11 8 9 9 10 13 1 10 0
0 7 1 1 6 3 10 10 4 6 14 0
0 9 12 2 5 13 5 8 6 7 10 0
0 0 0 0 0 0 0 0 0 0 0 0
