0 0 0 0 0 0 0 0 0 0 0 0
0 1 2 3 1 2 3 4 5 6 4 0
0 7 8 9 7 8 9 10 11 12 10 0
0 13 14 1 13 14 1 2 3 4 2 0
0 5 6 7 5 6 7 8 9 10 8 0
0 11 12 13 11 12 13 14 1 2 14 0
0 3 4 5 3 4 5 6 7 8 6 0
0 9 10 11 9 10 11 12 13 14 12 0
0 1 2 7 8 1 2 7 8 3 4 0
0 9 10 11 12 9 10 11 12 13 14 0
0 5 6 13 14 5 6 13 14 1 2 0
0 0 0 0 0 0 0 0 0 0 0 0
