0 0 0 0 0 0 0 0 0 0 0 0
0 8 14 13 6 8 1 1 14 1 12 0
0 12 6 2 3 9 11 7 3 10 10 0
0 1 12 9 6 3 4 6 14 10 13 0
0 2 5 2 13 5 14 7 4 9 7 0
0 11 8 9 10 6 5 2 7 7 12 0
0 4 3 3 11 2 4 5 14 1 4 0
0 8 11 2 11 11 4 13 14 10 1 0
0 12 13 11 5 3 13 1 10 6 8 0
0 8 5 8 7 9 2 5 7 12 9 0
0 2 6 10 13 14 9 4 12 10 3 0
0 0 0 0 0 0 0 0 0 0 0 0
