0 0 0 0 0 0 0 0 0 0 0 0
0 1 9 13 2 10 14 3 11 1 12 0
0 4 12 2 9 13 3 10 14 4 11 0
0 5 1 4 12 5 2 9 13 3 10 0
0 14 3 11 4 1 5 12 2 9 13 0
0 10 14 1 5 12 4 3 11 2 9 0
0 13 2 10 14 3 1 5 12 4 11 0
0 11 4 1 5 12 2 10 14 3 9 0
0 9 3 10 14 1 5 12 4 2 11 0
0 12 2 9 13 3 10 14 1 4 5 0
0 1 4 11 9 2 3 12 10 5 14 0
0 0 0 0 0 0 0 0 0 0 0 0
