0 0 0 0 0 0 0 0 0 0 0 0
0 2 8 14 3 3 8 4 2 14 7 0
0 12 4 5 10 1 6 6 1 5 13 0
0 4 1 9 9 1 14 11 10 6 8 0
0 3 14 8 5 7 12 7 9 10 12 0
0 9 12 14 11 3 6 13 10 2 4 0
0 11 7 3 2 13 4 8 12 6 1 0
0 6 5 2 1 7 9 10 1 13 13 0
0 5 4 11 8 3 7 12 13 9 10 0
0 2 13 11 6 5 14 10 11 14 2 0
0 7 12 9 5 12 1 8 4 6 13 0
0 0 0 0 0 0 0 0 0 0 0 0
