0 0 0 0 0 0 0 0 0 0 0 0
0 5 7 12 4 4 12 14 2 1 10 0
0 11 1 5 3 13 9 8 8 2 11 0
0 1 3 12 1 2 7 12 10 1 5 0
0 8 12 1 8 3 13 2 4 4 13 0
0 4 3 8 5 14 6 13 14 6 14 0
0 10 7 10 4 5 6 14 6 11 11 0
0 7 9 2 13 11 5 10 6 3 8 0
0 9 13 9 9 1 10 10 14 3 9 0
0 14 2 6 10 8 1 6 7 13 7 0
0 11 7 8 13 9 2 5 12 4 12 0
0 0 0 0 0 0 0 0 0 0 0 0
