0 0 0 0 0 0 0 0 0 0 0 0
0 1 5 2 6 3 7 4 8 9 10 0
0 11 12 13 14 1 5 2 6 3 7 0
0 4 8 9 10 11 12 13 14 1 5 0
0 2 6 3 7 4 8 9 10 11 12 0
0 13 14 1 5 2 6 3 7 4 8 0
0 9 10 11 12 13 14 1 5 2 6 0
0 3 7 4 8 9 10 11 12 13 14 0
0 1 5 13 14 2 6 11 12 3 7 0
0 4 8 9 10 1 5 13 14 2 6 0
0 11 12 3 7 4 8 9 10 1 5 0
0 0 0 0 0 0 0 0 0 0 0 0
