0 0 0 0 0 0 0 0 0 0 0 0
0 3 8 10 13 3 8 10 13 1 6 0
0 2 9 9 2 1 6 4 11 4 11 0
0 5 7 12 14 5 7 12 14 3 8 0
0 10 13 1 6 10 13 1 6 2 9 0
0 4 11 5 7 4 11 5 7 12 14 0
0 3 8 12 14 3 8 12 14 10 13 0
0 1 6 2 9 1 6 2 9 4 11 0
0 5 7 3 8 5 7 3 8 1 6 0
0 10 13 4 11 10 13 4 11 5 7 0
0 12 14 1 6 12 14 1 6 3 8 0
0 0 0 0 0 0 0 0 0 0 0 0
