0 0 0 0 0 0 0 0 0 0 0 0
0 1 6 12 4 11 2 14 10 8 12 0
0 14 5 12 4 2 13 1 11 13 14 0
0 5 10 13 3 11 2 14 3 12 9 0
0 4 1 2 7 6 9 8 8 10 7 0
0 11 14 13 11 6 9 8 2 6 1 0
0 5 4 3 5 11 4 10 3 14 6 0
0 12 14 3 9 6 7 2 3 5 2 0
0 8 13 7 8 5 4 2 10 13 10 0
0 12 12 8 3 7 9 10 12 1 2 0
0 13 9 5 1 6 13 1 12 4 10 0
0 0 0 0 0 0 0 0 0 0 0 0
