0 0 0 0 0 0 0 0 0 0 0 0
0 5 13 10 14 14 10 4 4 11 5 0
0 12 4 2 2 13 7 7 11 2 5 0
0 5 10 14 6 8 13 11 4 9 9 0
0 11 8 1 2 6 7 3 3 10 6 0
0 12 10 3 8 12 12 13 11 6 3 0
0 5 1 1 14 13 4 8 7 13 9 0
0 6 6 8 4 1 9 1 1 9 2 0
0 8 9 4 10 14 7 12 2 3 7 0
0 3 12 13 1 1 5 2 9 8 14 0
0 6 12 11 14 3 7 10 10 5 8 0
0 0 0 0 0 0 0 0 0 0 0 0
