0 0 0 0 0 0 0 0 0 0 0 0
0 14 4 1 9 8 7 11 2 12 9 0
0 14 13 14 1 2 1 12 3 6 11 0
0 2 4 5 10 4 6 8 8 11 3 0
0 6 9 3 2 5 13 5 1 13 6 0
0 6 5 10 9 13 7 2 12 7 10 0
0 4 12 11 7 3 14 8 12 8 7 0
0 9 14 10 8 4 9 11 3 10 3 0
0 1 13 5 2 2 11 5 10 1 4 0
0 14 8 6 13 7 1 12 13 6 4 0
0 5 8 10 12 9 7 3 5 11 3 0
0 0 0 0 0 0 0 0 0 0 0 0
