0 0 0 0 0 0 0 0 0 0 0 0
0 1 4 7 10 13 2 5 8 11 14 0
0 2 5 8 11 14 1 4 7 10 13 0
0 3 6 9 12 1 3 6 9 12 2 0
0 4 7 10 13 3 5 8 11 14 6 0
0 5 8 11 14 4 7 10 13 3 9 0
0 6 9 12 2 5 8 11 14 4 10 0
0 7 10 13 3 6 9 12 1 5 11 0
0 8 11 14 4 7 10 13 2 6 12 0
0 9 12 1 5 8 11 14 3 7 13 0
0 10 13 2 6 9 12 1 4 8 14 0
0 0 0 0 0 0 0 0 0 0 0 0
