0 0 0 0 0 0 0 0 0 0 0 0
0 1 2 3 4 5 6 7 8 9 10 0
0 1 2 3 4 5 6 7 8 9 10 0
0 11 12 13 14 1 2 3 4 5 6 0
0 11 12 13 14 1 2 3 4 5 6 0
0 7 8 9 10 11 12 13 14 1 2 0
0 7 8 9 10 11 12 13 14 1 2 0
0 3 4 5 6 7 8 9 10 11 12 0
0 3 4 5 6 7 8 9 10 11 12 0
0 13 14 1 2 3 4 5 6 7 8 0
0 13 14 1 2 3 4 5 6 7 8 0
0 0 0 0 0 0 0 0 0 0 0 0
