0 0 0 0 0 0 0 0 0 0 0 0
0 14 4 10 3 3 14 13 2 6 14 0
0 5 12 12 1 8 13 8 3 12 6 0
0 5 7 9 13 7 3 1 2 14 4 0
0 1 2 2 11 5 1 8 8 1 9 0
0 11 9 4 1 10 13 11 6 6 7 0
0 9 4 7 1 2 14 13 4 5 10 0
0 8 12 12 12 1 4 7 3 10 13 0
0 6 11 1 5 5 14 11 5 2 11 0
0 8 6 7 9 10 10 11 10 2 9 0
0 2 13 12 9 6 3 4 8 7 10 0
0 0 0 0 0 0 0 0 0 0 0 0
