0 0 0 0 0 0 0 0 0 0 0 0
0 1 4 8 12 2 5 9 13 3 6 0
0 7 10 11 14 1 4 8 12 2 5 0
0 9 13 3 6 7 10 11 14 1 4 0
0 8 12 2 5 9 13 3 6 7 10 0
0 11 14 1 4 8 12 2 5 9 13 0
0 3 6 7 10 11 14 1 4 8 12 0
0 2 5 9 13 3 6 7 10 11 14 0
0 1 4 3 6 8 12 7 10 2 5 0
0 9 13 11 14 1 4 3 6 8 12 0
0 7 10 2 5 9 13 11 14 1 4 0
0 0 0 0 0 0 0 0 0 0 0 0
