0 0 0 0 0 0 0 0 0 0 0 0
0 4 9 14 1 7 11 11 4 9 13 0
0 6 4 10 7 8 9 2 6 10 5 0
0 3 5 1 8 10 4 2 12 10 7 0
0 6 3 12 13 1 9 13 14 2 6 0
0 5 14 8 12 6 14 5 11 8 8 0
0 12 11 14 2 3 2 13 8 7 10 0
0 2 9 1 11 1 13 11 10 1 5 0
0 4 12 3 14 10 5 1 12 3 6 0
0 13 4 8 12 9 3 5 13 7 7 0
0 9 1 11 2 4 8 14 13 2 10 0
0 0 0 0 0 0 0 0 0 0 0 0
